1111111111111111111111111111111111111111
1CCCCCCCCCCC11CCCCCCCCCCC111111111100001
1C1111C1111C11C1111C1111C111111111100001
1C1111C1111C11C1111C1111C111111111100001
1CCCCCCCCCCCCCCCCCCCCCCCC111111111100001
1C1111C1C11111111C1C1111C111111111100001
1CCCCCC1CCCC11CCCC1CCCCCC111111111100001
111111C111101101111C11111111111111100001
111111C100000000001C11111111111111100001
111111C101110011101C11111111111111100001
10CCCCC001000000100CCCCCE111111111100001
111111C101111111101C11111111111111100001
111111C100000000001C11111111111111100001
111111C101111111101C11111111111111100001
1CCCCCCCCCCC11CCCCCCCCCCC111111111100001
1C1111C1111C11C1111C1111C111111111100001
1CCC11CCCCCC0PCCCCCC11CCC111111111100001
111C11C1C11111111C1C11C11111111111100001
111C11C1C11111111C1C11C11111111111100001
111C11C1C11111111C1C11C11111111111100001
111C11C1C11111111C1C11C11111111111100001
1111111111111111111111111111111111111111