1111111111110
10000000000C1
1110011111011
1P1E110000001
1111111111111