1111111111111
1001E00000001
1000001111000
1P0011E000001
1111110111111